"a" = (/turf/wall,/area)
"b" = (/turf/floor,/area)
"c" = (/turf/start,/area)

(1,1,1) = {"
aaaaaaaaaa
abbbbbbbba
abbbbbbbba
abbbbbbbba
abbbbcbbba
abbbbbbbba
abbbbbbbba
abbbbbbbba
abbbbbbbba
aaaaaaaaaa
"}
